02010101000010110000010001001
00000000000000000000000000000
11111100111111011111101111111
11111100000000000111111111111
10000000000000000000000100100
11100001010100011000011000001
11111100001000010000100000000
00000000000000000010011110111
11111111111000000000011110000
00000000011111000000000000030
10000100000010000000011111111
